1111111111
1C01CC00E1
10PC1C0C1P
10010C0001
10C00C00C1
1111111111