0000000000
0C00000000
0E00000C00
0P00000000
0000000000