1111111111
1C01CC00E1
100C1C0C11
10010C0P01
1PC00C00C1
1111111111