1111111111
1C01CC00E1
100C1C0C11
11010C0001
1P100C00C1
1111111111