1111111111
1C011C00E1
100C1C0C11
10011C0001
1PC01C00C1
1111111111