1111111111
1C011CCCE1
100C1CC111
10011CC101
1PC000C101
1111111111