1111111111
1C01{C00E1
100C1C0C11
10010C0001
1PC00C00C1
1111111111