1111111111
1C01CC00E1
100C1C0C11
10010C0001
1PC00Cy0C1
1111111111