1111111111111111111111111
11110001111111111100000E1
1110C00000001111000001111
1111111000011110000111111
1111100001111111100011111
1111000000000111000000C11
111000000C000000001111111
1100000001100000000000011
1111111000000000111111111
1111100000000000011111111
111000000000000000000C011
1100000000000001111111111
1000000000000111111110111
100000000P000C00000000C11
1111111111111111111111111
