1111111111
1001C000E1
100C1C0C11
1001010001
1CC00CCCC1
1111P11111
