11111111111
10000100001
10001110001
10000100001
10PCE000001
11111111111
