1111111111111111
1C01CC00E00C0001
110C110C10000001
10000C0000000P01
1111111111111111
