1111111111
11000000E1
1001100011
1001000001
1P10010011
1111111111