1111111111
1C000000E1
1C00000011
10000000C1
1P00000001
1111111111